<level name="Beginners" version='0.1'>
<comment>
Hey this is the beginner level :)
If you can't win this, you are stupid !
</comment>
<stage id=1>
1111111111111111111111111
1377700007272709070000001
1070700000200007070700001
1072200007270107070200501
1000700027270007080000001
1111111111111111111111111
1600001000007670000610001
1000002000007071121110001
1000001050007570000000041
1777777777777777707777771
1111111111111111111111111
</stage>
<stage id=2>
1111111111111111111111111
1300000000000000000000041
1111111111111111111111111
</stage>
<stage id=3>
1111111111111111111111111
1377700007272709070000001
1070700000200007070700001
1072200007270107070200501
1000700027270007000000001
1111111111111111111111111
1600001000007670000610001
1000002000007071121110001
1000001050007570000000041
1777777777777777707777771
1111111111111111111111111
</stage>
<stage id=4>
1111111111111111111111111
1377700007272709070000001
1070700000200007070700001
1072200007270107070200001
1000700027270007000000041
1111111111111111111111111
</stage>