<level name="Beginners" version='0.2'>
<comment>
Hey this is the beginner level :)
If you can't win this, you are stupid !
HA ! Sogar JPushy kan AAAA eingeben ohne abzukacken !
</comment>
<stage id=1>
1111111111111111111111111
1377700007272709070000001
1070700000200007070700001
1072200007270107070200501
1000700027270007000000001
1111111111111111111111111
1600001000007670000610001
1000002000007071121110001
1000001050007570000000041
1111111111111111101111111
1111111111111111111111111

</stage>