<level name="Beginners" version='0.2'>
<stage id=0>
927272222727272227222222:
3B3030000?A?A?0H030000003
3030?00000A0000=030100003
30?AA00I0=A=01030?0A00D03
3000=000A3A300030G0000003
6222527225257275222272224
3E0000?000003E30000E30003
3000000000003062>A@2;0003
300000=0D0003D300000000C3
6222225222225252:09222224
<22222222222222252522222;
</stage>
<stage id=1>
927272222222222222222222:
3B3030000?A?A?00030000003
3030?00000A0000=030100003
30?AA0000=A=01030?0A00D03
3000=000A3A300030G0000003
6222572225257275222272224
3E000?0000003E30000E30003
30000A0000003062>A@2;0003
30000=0D00003D300000000C3
6222252222225252:09222224
<22222222222222252522222;
</stage>