<level name="Beginners" version='0.2'>
<stage id=0>
927272222727272227222222:
3B3030000?A?A?0H030000003
3030?00000A0000=030100003
30?AA00I0=A=01030?0A00F03
3000=000A3A300030G0000003
6222527225257275222272224
3F0000?000003F30000F30003
3000000000003062>A@2;0003
300000=0F0003F300000000C3
6222225222225252:09222224
<22222222222222252522222;
</stage>
<stage id=1>
927272222222222222222222:
3B3030000?A?A?00030000003
3030?00000A0000=030100003
30?AA0000=A=01030?0A00003
3000=000A3A300030G00000F3
6222572225257275222272224
3F000?0000003F30000F30003
30000A0000003062>A@2;0003
30000=0F00003F300000000C3
6222252222225252:09222224
<22222222222222252522222;
</stage>