<level name="error" version='0.1'>
<stage id=0>
11111111111111111111111
10000000000000000000001
10111011001100111011001
10100010101010101010101
10111010101010101010101
10100011001100101011001
10111010101010111010101
10000000000000000000001
11111111111111111111111
</stage>
