<level name="Hallo Welt" version='0.1'>
<stage id=0>
11111111
13010101
10010001
10010101
10012101
10010101
10000141
11111111
</stage>