<level name="impossiblewithoutitems" version='0.1'>
<stage id=0>
1111111111111111
1000000010110901
1000000000890141
1000000110111111
1111111100000001
1111100000000001
11111:1000000001
1111111111111111
</stage>
<stage id=1>
1111111111111111
1000000000000001
1000000000000001
1000000000000001
1000000000000001
1000000000000001
1000000000000001
1111111111111111
</stage>
<stage id=2>
1111111111111111
1000000000000001
1000000000000001
1000000000000001
1000000000000001
1000000000000001
1000000000000001
1111111111111111
</stage>
<stage id=3>
1111111111111111
1000000000000001
1000000000000001
1000000000000001
1000000000000001
1000000000000001
1000000000000001
1111111111111111
</stage>
