<level name="itemtest" version='0.1'>
<stage id=0>
11111111
13000001
10000001
10000001
10000001
10000001
10000041
11111111
</stage>
