<level name="JPushy-Level23" version='1.0'>
<stage id=0>
9222222222222222222:
30000000000000000003
30922>C@2:0000000003
30300000030000000003
303J00000?0P00O0O003
303L0O0O0H0L0010M003
303U00000=0000000003
303092222;0000000003
30303000000000000003
30303000000000000003
303B3000000000000003
<252522222222222222;
</stage>
