<level name="JPushy-Level23" version='1.0'>
<stage id=0>
9222222222222222222:
30000000000000000003
301111C1110000000003
30100000010000000003
301J0000010P00O0O003
301L0O0O0H0L0010M003
301U0000010000000003
30101111110000000003
30101000000000000003
30101000000000000003
301B1000000000000003
<222222222222222222;
</stage>
