<level name="JPushy-Level18" version='1.0'>
<stage id=0>
9222222222222222222:
30000000000010000003
30L00000000010000003
30000000000000000N03
30000000000010000003
30000000000010000003
311H1100000001111113
3C0AR010000010000003
300F00100J0000F00O03
30000010000010000003
3B000010000010000003
<222222222222222222;
</stage>
