<level name="JPushy-Level18" version='1.0'>
<stage id=0>
9222222222227222222:
30000000000030000003
30L000000000?0000003
30000000000000000N03
300000000000=0000003
300000000000?0000003
62>H@>0000000@222224
3C0AR0=0000010000003
300F00300J0000F00O03
300000300000=0000003
3B000030000030000003
<222225222225222222;
</stage>
