<level name="JPushy-Level4" version='1.0'>
<stage id=0>
9222222222222222222:
30000000000000000003
30C0000M000000000003
30000000000000000003
30000000000000000003
62222222222222:00003
62222222222222;00003
30000000000000000003
30000000000000000003
30B0000P000000000003
30000000000000000003
<222222222222222222;
</stage>
