<level name="JPushy-Level1" version='1.0'>
<comment>
This is a recreation of the Pushy level 1
</comment>
<stage id=0>
9222222272222222222:
30000000300000000003
30000000300000000003
30000000300000000003
3000=00030009222>003
30003000300030000003
30003000300030000003
30003000300030000003
30003000?000300@2224
30B030000000300000C3
30003000000030000003
<222522222225222222;
</stage>
