<level name="JPushy-Level7" version='1.0'>
<stage id=0>
9222222222222222222:
3C000000000000000003
30000000010000000003
300@2>00001000@2>003
30=000000A0000000=03
3030P00000A0000B0303
3030P0000A00000M0303
30?0000000A000000?03
300@2>00010000@2>003
30000000001000000003
30000000000000000003
<222222222222222222;
</stage>
