<level name="JPushy-Level5" version='1.0'>
<stage id=0>
9222222222222222222:
30000000000000000003
30000000000000000003
300P0000000B00000003
300P000M000000000003
300P0000000000000003
30000000000000000003
30000000000000000003
30000000000000000AA3
3000000000000000A003
3000000000000000A0C3
<222222222222222222;
</stage>
