<level name="JPushy-Level20" version='1.0'>
<stage id=0>
9222222222222222222:
30000000000000000003
31111111100000000003
30011111100000000003
30Q11111100000000003
30Q01111100000000003
3000B011100000000003
31FH001C100000000003
3000P000100000000003
31AJ0P00100000000003
3F00000K100000000003
<222222222222222222;
</stage>
