<level name="JPushy-Level19" version='1.0'>
<stage id=0>
9222222222222222222:
3C000000000000000003
30000000000000000003
31111AH1111110000003
30000000000010000003
300000000000100N0003
30O010S0100010000003
30O010S01000100S0003
30001000100010000003
300010001000100M0003
30B01000100010000003
<222222222222222222;
</stage>
