<level name="JPushy-Level22" version='1.0'>
<stage id=0>
9222222222222222222:
300010001000000010C3
3000U000100000001003
30001000100000001003
311H1000100010001003
30001000100010001003
3J001000100010001003
30001000100010001003
30001000000010000003
3A001000000010000003
300B1000000010000003
<222222222222222222;
</stage>
