<level name="JPushy-Level25" version='1.0'>
<stage id=0>
9222222222222222222:
30000000010000000003
300J0A10011111L00003
30O00000010000A0A003
310A100001AAO0AA0003
30A00000010000100003
30F0B0000F0PMU000003
300000000111110UUUU3
300C0000100000000003
30000000H00000000003
30000000100000000003
<222222222222222222;
</stage>
