<level name="JPushy-Level12" version='1.0'>
<stage id=0>
9222222222222222222:
30000010000000000003
30B0M010000000000003
300A0A10000000000003
300PE010000000000003
30A00D10000000000003
311P1100000000000003
30000000000000000003
30P0000000000000C003
300DE000000000000003
30000000000000000003
<222222222222222222;
</stage>
