<level name="JPushy-Level24" version='1.0'>
<stage id=0>
9222222222222222222:
30000000010000J00003
3000000F010FA0A00003
300U0000010A0AA00003
3010100001A000000003
301B10K0010000000003
300A0000010000000003
3000A000011111111113
300OA0Q0010000000003
300000000H000N000003
300000000A00000000C3
<222222222222222222;
</stage>
