<level name="JPushy-Level17" version='1.0'>
<stage id=0>
9222222222222222222:
3C000000000000000003
31111111111100000003
3000000000F1F0000003
30Q000000001000S0003
300001AAA001000N0003
30J000A0A0010SOMOS03
30000A0A1001000N0003
3111H1A01001000S0003
3K0O0000A00100000003
3B000000A00100000003
<222222222222222222;
</stage>
