<level name="JPushy-Level22" version='1.0'>
<stage id=0>
9222722272222222722:
3000?0003000000030C3
3000U000300000003003
3000=000300000003003
62>H30003000=0003003
30003000300030003003
3J003000300030003003
30003000?0003000?003
30003000000030000003
3A003000000030000003
300B3000000030000003
<222522222225222222;
</stage>
