<level name="JPushy-Level21" version='1.0'>
<stage id=0>
9222222222222222222:
300000000001000000F3
30A000AAJ00100000003
300A0010000100000003
3B00A010A00100000003
30AA0A10000100000003
3000A0AA0AAH00Q00003
300A00A0A00100000003
30A01A00000100000003
30P01K00000100000003
3C0F1000000100000003
<222222222222222222;
</stage>
