<level name="JPushy-Level3" version='1.0'>
<comment>
This is a recreation of the Pushy level 3
</comment>
<stage id=0>
9222222272222222222:
3000000030A00A000003
30000000?A000A000003
30000000A00A0A000003
30000000=0A0AA000003
3000092252272222>0A3
30000?0A000300000=03
30000AA0000300@>0303
30000=0A000301C00?03
300003A00B0300@2>003
3000030000030000A003
<222252222252222222;
</stage>
