<level name="JPushy-Level16" version='1.0'>
<stage id=0>
9222222222222222222:
3F00000N0000000000K3
6222222222222:000003
3B0000000000C3000003
30000000000003000003
30R00000000003000003
622>A1A0000003000003
30P00HA0000003000003
3000A0A0O00J03000003
30L0A0A0000003000003
3F00A0A0000003000003
<222222222222522222;
</stage>
