<level name="JPushy-Level14" version='1.0'>
<stage id=0>
9222272222722222222:
392228222:3000000003
6;0003000<4000000003
300K0?0M003000000003
30000000003000000003
300S0Q0Q003000000003
30000000003000000003
3000O0O0003000000003
6:00AOA0094000000003
33000B00033000000003
3<:00C009;3000000003
<252222252522222222;
</stage>
