<level name="LukasMamaStinkt" version='0.1'>
<stage id=0>
11111111
13007771
10181171
10100171
10100141
10111111
10000001
11111111
</stage>
