<level name="Puzzle-1" version='1.0'>
<stage id=0>
9222272222222222222:
3B000300000000000003
30000?00000000000J03
30000H00000000000003
300I0=00000000000003
62222;00000000092224
3000000000000D03E003
62222>00000000030003
3E000A0000000006>H@4
62222>00000000030003
30000D000000000300C3
<222222222222225222;
</stage>
