<level name="test" version='0.1'>
<stage id=0>
11111111
13000001
10<<<<01
10<00<01
10<04<01
10<<<<01
10000001
11111111
</stage>
