<level name="Test" version='1.1'>
<stage id=0>
9222222272222222222:
3B00000D3E00000000D3
300000003000000000E3
62222722;00000922224
300003000000003FFFF3
300003000000003DEFF3
30ED062>H@22224FFFF3
30I00300000DE03FFFF3
300003000000003FFFC3
<222252222222252222;
</stage>
