<level name="Untitled" version='0.1'>
<stage id=0>
11111111
13077001
17077001
17777001
17777001
10011181
10000141
11111111
</stage>
