<level name="JPushy-Level9" version='1.0'>
<stage id=0>
9222222222222222222:
30000000000000000003
30000000000000000003
30000000000000000003
30092222222:00000003
622;0000000300000003
3000N0PO000300000003
300000A0A00300000003
3000OM0N0P0300000003
30000L010B0300000003
3C000K01000300000003
<222222222252222222;
</stage>
