<level name="JPushy-Level21" version='1.0'>
<stage id=0>
9222222222272222222:
300000000003000000F3
30A000AAJ00300000003
300A00=0000300000003
3B00A030A00300000003
30AA0A?0000?00000003
3000A0AA0AAH00Q00003
300A00A0A00=00000003
30A0=A00000300000003
30P03K00000300000003
3C0F3000000300000003
<222522222252222222;
</stage>
