<level name="JPushy-Level24" version='1.0'>
<stage id=0>
9222222227222222222:
30000000030000J00003
3000000F030FA0A00003
300U0000030A0AA00003
30=0=00003A000000003
30?B?0K0030000000003
300A0000030000000003
3000A000062222222224
300OA0Q00?0000000003
300000000H000N000003
300000000A00000000C3
<222222222222222222;
</stage>
