<level name="JPushy-Level6" version='1.0'>
<stage id=0>
9222222722272222222:
30000003000300000003
300000030M0300000003
3000000?000?00000003
30000000000000000003
30000P000A000P000003
300000000=0000000003
30000@2225222>000003
30000000000000000003
300000000B0000000003
300000000000000000C3
<222222222222222222;
</stage>
