<level name="JPushy-Level8" version='1.0'>
<stage id=0>
9222222222222222222:
300000000000000000C3
30000000000000000003
3000K0000M0000L00094
30000000000000000033
30000000000000000033
30000000000000000033
3000A0000A0000A00033
300APA00AOA00ANA00<4
3000A0000A0000A00003
300000000000000000B3
<222222222222222222;
</stage>
