<level name="JPushy-Level17" version='1.0'>
<stage id=0>
9222222222222222222:
3C000000000000000003
62222222222:00000003
3000000000F3F0000003
30Q000000003000S0003
300001AAA003000N0003
30J000A0A0030SOMOS03
30000A0A=003000N0003
622<H1A0?003000S0003
3K0O0000A00300000003
3B000000A00300000003
<222222222252222222;
</stage>
