<level name="JPushy-Level19" version='1.0'>
<stage id=0>
9222222222222222222:
3C000000000000000003
30000000000000000003
6222>AH@2222:0000003
30000000000030000003
300000000000300N0003
30O0=0S0=00030000003
30O030S030J0300S0003
30003000300030000003
300030003000300M0003
30B03000300030000003
<222522252225222222;
</stage>
