<level name="JPushy-Level15" version='1.0'>
<stage id=0>
9222222222222222222:
30000000000000000003
30000000000000000003
622222:0000000000003
300000300000000L0003
30B0A030000000000003
300000?0000000000003
300O0H0000000@222224
300J00=0000000000003
300000?0000000000C03
30000000000000000003
<222222222222222222;
</stage>
