<level name="JPushy-Level13" version='1.0'>
<stage id=0>
9222222222222222222:
30000000000000000003
30000000000000000003
3000000000S00M00N003
30000000000000000003
30000000000000000003
30000000000000000003
30000000000000000003
30000000000000000003
30B00000000000000003
300000000000000000C3
<222222222222222222;
</stage>
