<level name="JPushy-Level25" version='1.0'>
<stage id=0>
9222222227222222222:
30000000030000000003
300J0A1006222>L00003
30O00000030000A0A003
6>0A100003AAO0AA0003
30A000000?0000100003
30F0B0000F0PMU000003
300000000@222>0UUUU3
300C0000100000000003
30000000H00000000003
30000000=00000000003
<222222252222222222;
</stage>
