<level name="JPushy-Level10" version='1.0'>
<stage id=0>
9222222222222222222:
3B000000000000000003
30000000000000000003
30000A0000M000000003
3009>0100000000A0003
3003KA0@22222>ANA@74
300<>0A00000000A0C33
30000A00000000000@54
30000000000000000003
3000000000P000000003
30000000000000000003
<222222222222222222;
</stage>
