<level name="JPushy-Level2" version='1.0'>
<comment>
This is a recreation of the Pushy level 2
</comment>
<stage id=0>
9222222722227222222:
30000003000030000003
30000003000030000003
3000000?000030000003
30B0000A000030000003
3000000=000030000003
6222222;AAAA30000003
3000000A000030000003
3000000A000030000003
30C0000A000030000003
3000000A000030000003
<222222222225222222;
</stage>
