<level name="JPushy-Level20" version='1.0'>
<stage id=0>
9222222222222222222:
30000000000000000003
62277777:00000000003
30068888400000000003
30Q<8888400000000003
30Q0<588400000000003
3000B065400000000003
6>FH00?C300000000003
3000P000300000000003
6>AJ0P00300000000003
3F00000K300000000003
<222222252222222222;
</stage>
