<level name="JPushy-Level11" version='1.0'>
<stage id=0>
9222222722222222222:
300000030000000000B3
3000000?000000000003
30P0000A00000F000003
3000000=000000000003
62222224000000000003
3M000P03000000000003
3000000300000000P003
300000030000000PMP03
3P000F030C000000P003
30000003000000000003
<222222522222222222;
</stage>
