<level name="Test Level" version='0.1'>
<stage id=0>
1111111111111111
1311111111111111
1010000011000111
1010111011200111
1020001000020111
1200101121110111
1110001111110041
1111111111111111
</stage>
<stage id=1>
1111111111111111
1000202011100011
1101020000100211
1100200010102011
1101220010201011
1101220010021011
1401020010001031
1111111111111111
</stage>
<stage id=2>
1111111111111111
1000000000000001
1000000000000001
1000000000000001
1000000000000001
1000000000000001
1000000000003041
1111111111111111
</stage>
<stage id=3>
1111111111111111
1000000000000001
1000000000000001
1000000000000001
1000000000000001
1000000000000001
1000000000003041
1111111111111111
</stage>
